NO     ./textures/eagle.xpm
SO   ./textures/colorstone.xpm
F   150,222,50
WE   ./textures/redbrick.xpm
EA     ./textures/greystone.xpm

C                 82,82,82
1111111111111111111111
100000111010N0000000011111
11000011110000000000111
11110111100000000000111
11111111111111111111111