NO     ./path_to_the_north_texture
SO   ./path_to_the_south_texture
F   150,222,50
WE   ./path_to_the_west_texture
EA     ./path_to_the_east_texture

C                 82,82,82
1111111111111111111111
1000001110000000000011
1011001110100010000011
1001001111000000000011
11111111100100000000111111111111
10000011100010000000111
11110111100000000000111
11110111100000000000111
110000111000001000001111
100000111N000000000011111
1000001110100000000011111
11000011100000000000111
11110111100000000000111
11111111111111111111111