NO     ./textures/eagle.xpm
SO   ./textures/colorstone.xpm
F   255,255,255
WE   ./textures/redbrick.xpm
EA     ./textures/greystone.xpm

C                 192,82,82





111111111111111111111111111
1000001110100000000011111
11000000000000000000111
11000000001000000000111
11000000010100000000111
11000000010100000000111
11000000001000000000111
1100000000000000000111
11000000000000000000111
11111111111111111111111