NO     ./textures/eagle.xpm
SO   ./textures/colorstone.xpm
F   128,0,0
WE   ./textures/redbrick.xpm
EA     ./textures/greystone.xpm

C                 192,82,82
1111111111111111111111
100000111010N0000000011111
11000011110000000000111
11110111100000000000111
11111111111111111111111