NO     ./textures/eagle.xpm
SO   ./textures/colorstone.xpm
F   128,0,0
WE   ./textures/redbrick.xpm
EA     ./textures/greystone.xpm

C                 192,82,82
1111111111111111111111
10000011101000000000011111
11000000000000000000111
11000000001000000000111
11000000010100000000111
11000000010100000000111
11000000001000000000111
11000000000000000000111
1100000000N000000000111
11000000000000000000111
11000000000000000000111
11000000000000000000111
11000000000000000000111
11000000000000000000111
11000000000000000000111
11000000000000000000111
11000000000000000000111
11000000000000000000111
11000000000000000000111
11000000000000000000111
11000000000000000000111
11000000000000000000111
11000000000000000000111
11000000000000000000111
11000000000000000000111
11000000000000000000111
11000000000000000000111
11000000000000000000111
11000000000000000000111
11000000000000000000111
11000000000000000000111
11000000000000000000111
11000000000000000000111
11000000000000000000111
11000000000000000000111
11000000000000000000111
11000000000000000000111
11000000000000000000111
11000000000000000000111
11000000000000000000111
11000000000000000000111
11000000000000000000111
11000000000000000000111
11000000000000000000111
11000000000000000000111
11000000000000000000111
11000000000000000000111
11000000000000000000111
11000000000000000000111
11111111111111111111111