NO     ./textures/eagle.xpm
SO   ./textures/redbrick.xpm
F   128,0,05
WE   ./textures/purplestone.xpm
EA     ./textures/greystone.xpm

C                 192,82,82
111111111111111111111111111
1H0000111010W0000000011111
110000000000H0000000111
110000000010H0000000111
11000000010100000000111
110000000101000H0000111
110000000010000H0000111
1100000000D0000H0000111
1H00000000100000000H111
11111111111111111111111