NO     ./textures/eagle.xpm
SO   ./textures/redbrick.xpm
F   128,0,05
WE   ./textures/purplestone.xpm
EA     ./textures/greystone.xpm

C                 192,82,82
111111111111111111111111111
100000111010W0000000011111
11000000000000000000111
11000000001000000000111
11000000010100000000111
11000000010100000000111
11000000001000000000111
11000000000000000000111
11000000000000000000111
11111111111111111111111