NO     ./textures/eagle.xpm
SO   ./textures/redbrick.xpm
F   128,0,05
WE   ./textures/purplestone.xpm
EA     ./textures/greystone.xpm

C                 192,82,82



111111111111111111111111111
100000111010W0000000011111
110000000010H0000000111
1100000000D0H0000000111
11000000011100000000111
110000000101000H0000111
110000000010000H0000111
1100000000D0000H0000111
10000000001000000000111
11111111111111111111111



