NO ./path_to_the_north_texture
SO ./path_to_the_south_texture
F   150,222,50
WE   ./path_to_the_west_texture
EA     ./path_to_the_east_texture

C                 82,82,82
11111111111111111111111111111
10000000001100000000000000001
10110000011100000010000010001
10010000000000100000000010001
10110000011100000100000010011
10000000001100000111011110001
11110111111111011100000010001
11110111111111011101010010001
11000000110101011100000010001
10001000000000001100000000001
10000000000000001101010010001
10000000000000001101010000N01
11000000110101011111011110001
11110111111101011111011110001
11111111111111111111111111111
10001000000000001100000010001
10000000000000001101010010001
11111111111111111111111111111