NO     ./path_to_the_north_texture
SO   ./path_to_the_south_texture
F   150,222,50
WE   ./path_to_the_west_texture
EA     ./path_to_the_east_texture

C                 82,82,82
1111111111111111111111
1000000000000000000011
1011000000000010000011
10000000N0000000000001
1000000000001000000001
1000000000000000000001
11111111111111111111111